50x120* o12
************************************************************************************************************************
** ** *  *   *   *        * * *    *       * *    *       *   *             **        *      *                 *       *
*                    *    *    *  *    **   **    **    *     *    *  **   *   *           *  *    ** *   *  *         *
**           *        *  **   *           **  **  *     *      *             * *    **     **            *  **       * *
***  *  **            *  ** *        * *       * *       *        *      *  * * *   **   *  *      * * *         *     *
*  ** * ** *         *             *   *       ***             *  *   *        *    *    * ** ** *      *      *    * **
*  * *          *  *                *                   **            * **** *   * *       *      *     * * ** *      **
***  *        * *  * *        *     *  **  ** **      ***    * *      *      *      ** *       * *      *   *    *     *
**    * **    *  * *  *     *  *    **           *   *         * *       * * *   *             *   *      **        *  *
** * *       **   * *           **  **      *   *   *    * *             *  * * * *  **  * * *  *   *       * *  *  * **
*    1*  *           *  *      * * *     *  *          **        ** *   **                             **     *    *  **
* * *                    **** *             **  ***  *  *   **    *        **  * *        * * *  *    *       * *  *** *
*      * *       * * *     *  *             *     *                *  ** * * **   **  **                            *  *
*        *            * * *    **    *    *  *     *       * *        *  *         *    *    *     *  **     *    *  ***
*   *      * * *             * *  **               *          **  *     **   *     *      *   *    *  *     *       *  *
*        *   **         *    *     ** *    * *** * *      *     * **   *     * ** * ** *            ***         *  *** *
*    *          *          *         *  **          *  *     ***  *    * *        * *           *     ***   **   *    **
*          * *   **  * *        *   * *        * **   ** * *     *  *    *  * *            *  ** *          *  *       *
*****  *  *   **     *           *        *     *  * *      * * *  *     * *                        *      **     **** *
* *  *    * *  *       *               * * *           * *          *  *   *  ***  *    ***  *             *           *
**                         *     *   ** *  *  **                *     *      *    ***      *      *                    *
*   *             *                  * *    **  *  *    *   * *     *     *   * *   * * **    *             *          *
*     **   *      *        *           *   ***                    *   * *    *  *      *  **  *       *  *    *     * **
***    *     **         ***                *  * *  * ** **  *  *     *  *  * *        *  *  ** * **  *     *   *     * *
*    **       **         *  *              * *     **        *  *        *    *     *      * *     **      **          *
*           *     * *         *     * **  *         *  * *  **    * *  *    * *   **           *    * **               *
** *        *** ***** *   *      *     *  *   *    *  *  *            *      * *  *    *      *****  *                 *
* * *      *  *         *  *   *  **      *     *     *  *  **  * *       *  *   *        *  **    *  ** *      *    * *
*  *  *       * ** *  * *    ** *  *  *   *      * *  *     *  *        * *   *   *   **         *       *   *  **     *
* ***         *       *   *   *  * ** ***      *    *  *     *   * *                   **   *         *       *    **  *
**         * *****                                *        **    *   *  *  *        **  *   *   *   * *   ** *  *   *  *
* **      *** *     **  **     *     *   *                       *  *    *     *      *       *       ** * *   *     * *
*     *      *          **       *       *      **          *   *  *  *  *  *** *   * ****   *   *      *   **  *      *
** *  ***       *        *  *  **      * *      **         *  *     *  *  *     *       * *             * *      *   * *
**          *     *   *          **           *   *            * * *   *         *      *    *  *  *  * *           *  *
*        *    *   ** * *     ** *  * *      *** *   *  * *  * *    *   *** **      *                    * *    *      **
*       *  *        * **          **    *        *      **    *    * *       *  *   *     *   **    **               * *
**       *      *   *  *     *      *   *   *      ***       *          *           *         *   * ***  * * *   *     *
*   *   *        *         ** *    *     **         *  *       *             *   *          ***   *      * * *      *  *
**    *   *        *      * **            *   * *      * * *            *    *  **               * *                 ***
*  *   *   * *          **       *         ** ***  *** *           *  *    *                  *    * *   *  *** * *    *
*            *  *         *   *    *         **  *   *          ** * * *** * *  * **              **   *               *
* *** *  *   *   *     ****         *    *        * * *       *       * * ***  ** *            *          *       *   **
*  *     *            * *    ** *     *       **  *   **     * *     *                  *  *         *     * *   *     *
*      **  ***      **   *          *         *  *       *    *  *           ***      ** ** *     *    ** *          * *
* * *     *     *    *           * * *      **   *    *            *      *          **        * *      *  *   **      *
**     *   *        *  * *    *    * * *   * *    *   **      * *   * *    **  *                       *        **  *  *
**  *   *       *     *  *   * **    *            *  * *   ***    *  *      ***   *   ***     *   *      **  *         *
*     * **   *  * *    **              ***   *  **  **  ** * *     *  * *         *    * *         ** *    * * *    *  *
*******************************************************************************************************2****************
