20x20* o12
***************1****
*     *   * *      *
**   **      *  ****
*     *  **        *
**  *            * *
*   *   *          *
***         **  *  *
**  *  *           *
* *   *** *     *  *
**       * *       *
* *        * * *   *
*     *          * *
*      *       *   *
*  *** *           *
*   *  * *    *  * *
* *      *      *  *
*    *   **   *    *
*  *       * ***   *
*       *        ***
***********2********
